111111
1C1E01
101101
101101
1P0C01
111111