111111111111111111111111111111111111
100C1C000000C0000000000000000C000001
10111111000000C0E0000000000000000101
1000P0000011100000100000000011110101
10000C000010C00000100000111110000101
1000000000100CC00000000011C0000P0101
1000000000100CC000000000110000000101
110111111110000000000000110000011101
1C0000010000000C0000000011000C010C01
100000010000001100000000110000000001
100000010000111111000000110000000001
100000111000001100000000110000000001
1000000100000001110000001100C0000001
100111101110000000000000111111111101
100000000110000000000000000000000001
1000C000011000000C0000000000000010C1
111111111111111111111111111111111111